laptop has no description.
trash can has no description.
sink has no description.
dishes has no description.

Morgana
An Interactive Fiction by Brianna
Release 1 / Serial number 250901 / Inform 7 v10.1.2 / D

Dorm Room
You are sitting in your dorm room on your bed in the small apartment you share with 2 other roommates. This room is small and cozy. You see a desk in the corner of the room. On the desk is a laptop.

>look
Dorm Room
You are sitting in your dorm room on your bed in the small apartment you share with 2 other roommates. This room is small and cozy. You see a desk in the corner of the room. On the desk is a laptop.

>look out window
I only understood you as far as wanting to look outside.

>look outside
You see nothing unexpected in that direction.

* * *

laptop has no description.
trash can has no description.
sink has no description.
dishes has no description.

Morgana
An Interactive Fiction by Brianna
Release 1 / Serial number 250901 / Inform 7 v10.1.2 / D

Dorm Room
You are sitting in your dorm room on your bed in the small apartment you share with 2 other roommates. This room is small and cozy. You see a desk in the corner of the room. On the desk is a laptop.

>open laptop
On the screen is a half-finished programming assignment. You've spent about 20 minutes working on it so far.

>turn on
What do you want to turn on?

>turn on the laptop
It isn't something you can switch.

* * *

>open laptop
On the screen is a half-finished programming assignment. You've spent about 20 minutes working on it so far.

>turn on laptop
It isn't something you can switch.

>x laptop
In the laptop is an assignment.

* * *

>open laptop
On the screen is a half-finished programming assignment. You've spent about 20 minutes working on it so far.

>x assignment
The c++ programming assignment is about half done.

* * *

>open laptop
On the screen is a half-finished programming assignment. You've spent about 20 minutes working on it so far.

>x assignment'
The c++ programming assignment is about half done.

>close laptop
You close the laptop.

>l
Dorm Room
You are sitting in your dorm room on your bed in the small apartment you share with 2 other roommates. This room is small and cozy. You see a desk in the corner of the room. On the desk is a laptop.

* * *

laptop has no description.
trash can has no description.
sink has no description.
dishes has no description.

Morgana
An Interactive Fiction by Brianna
Release 1 / Serial number 250901 / Inform 7 v10.1.2 / D

Dorm Room
You are sitting in your dorm room on your bed in the small apartment you share with 2 other roommates. This room is small and cozy. You see a desk in the corner of the room. On the desk is a laptop.

>s
common area
The common area contains a small couch, tv, dining table, and a kitchenette. The kitchenette has just a sink and a fridge.

The trash can is barely full.

>e
You can't go that way.

>w
You can't go that way.

>n
Dorm Room
You are sitting in your dorm room on your bed in the small apartment you share with 2 other roommates. This room is small and cozy. You see a desk in the corner of the room. On the desk is a laptop.

>w
You can't go that way.

>s
common area
The common area contains a small couch, tv, dining table, and a kitchenette. The kitchenette has just a sink and a fridge.

The trash can is barely full.

>wash dishes
dishes is now pretty and clean!.

* * *

>s
common area
The common area contains a small couch, tv, dining table, and a kitchenette. The kitchenette has just a sink and a fridge.

The trash can is barely full.

>x sink
In the sink is dishes.

>take dishes
Taken.

>put dishes in trash can
You put dishes into the trash can.

>take dishes from trash can
Ew, it's all dirty now, no thanks.

* * *

>x sink
In the sink is dishes.

>wash dishes
That's not a verb I recognise.

* * *

laptop has no description.
trash can has no description.
sink has no description.
dishes has no description.

Morgana
An Interactive Fiction by Brianna
Release 1 / Serial number 250901 / Inform 7 v10.1.2 / D

Dorm Room
You are sitting in your dorm room on your bed in the small apartment you share with 2 other roommates. This room is small and cozy. You see a desk in the corner of the room. On the desk is a laptop.

>sit at desk
I didn't understand that sentence.

>take laptop
Taken.

>open laptop
On the screen is a half-finished programming assignment. You've spent about 20 minutes working on it so far.

* * *

laptop has no description.
trash can has no description.
sink has no description.
dishes has no description.

Morgana
An Interactive Fiction by Brianna
Release 1 / Serial number 250901 / Inform 7 v10.1.2 / D

Dorm Room
You are sitting in your dorm room on your bed in the small apartment you share with 2 other roommates. This room is small and cozy. You see a desk in the corner of the room. On the desk is a laptop.

>switch on the laptop
It isn't something you can switch.

* * *

laptop has no description.
trash can has no description.
sink has no description.
dishes has no description.

Morgana
An Interactive Fiction by Brianna
Release 1 / Serial number 250901 / Inform 7 v10.1.2 / D

Dorm Room
You are sitting in your dorm room on your bed in the small apartment you share with 2 other roommates. This room is small and cozy. You see a desk in the corner of the room. On the desk is a laptop.

>take laptop
Taken.

>turn on laptop
It isn't something you can switch.

>x laptop
You see nothing special about the laptop.

* * *

laptop has no description.
trash can has no description.
sink has no description.
dishes has no description.

Morgana
An Interactive Fiction by Brianna
Release 1 / Serial number 250901 / Inform 7 v10.1.2 / D

Dorm Room
You are sitting in your dorm room on your bed in the small apartment you share with 2 other roommates. This room is small and cozy. You see a desk in the corner of the room. On the desk is a laptop.

>turn on laptop
You switch the laptop on.

>open laptop
It isn't something you can open.

* * *

>turn on laptop
You switch the laptop on.

>turn on computer
You can't see any such thing.

* * *

>turn on laptop
You switch the laptop on.

>x laptop
On the screen is a half-finished programming assignment. You've spent about 20 minutes working on it so far.

The laptop is currently switched on.

>open laptop
It isn't something you can open.

* * *

>x laptop
On the screen is a half-finished programming assignment. You've spent about 20 minutes working on it so far.

The laptop is currently switched on.

>x assignment
You can't see any such thing.

* * *

laptop has no description.
trash can has no description.
sink has no description.
dishes has no description.

Morgana
An Interactive Fiction by Brianna
Release 1 / Serial number 250901 / Inform 7 v10.1.2 / D

Dorm Room
You are sitting in your dorm room on your bed in the small apartment you share with 2 other roommates. This room is small and cozy. You see a desk in the corner of the room. On the desk is a laptop.

>turn on laptop\
You can't see any such thing.

>turn on laptop
You switch the laptop on.

>l
Dorm Room
You are sitting in your dorm room on your bed in the small apartment you share with 2 other roommates. This room is small and cozy. You see a desk in the corner of the room. On the desk is a laptop.

>take laptop
Taken.

>i
You are carrying:
  a laptop
  a watch (being worn)

>turn off laptop
You switch the laptop off.

>turn on laptop
You switch the laptop on.

* * *

laptop has no description.
trash can has no description.
sink has no description.
dishes has no description.

Morgana
An Interactive Fiction by Brianna
Release 1 / Serial number 250901 / Inform 7 v10.1.2 / D

Dorm Room
You are sitting in your dorm room on your bed in the small apartment you share with 2 other roommates. This room is small and cozy. You see a desk in the corner of the room. On the desk is a laptop.

>turn on radio
You switch the radio on.

Two characters in the radio play have begun an argument: "Did not!"

>z
Time passes.

The argument continues: "Did too!"

* * *

laptop has no description.
trash can has no description.
sink has no description.
dishes has no description.

Morgana
An Interactive Fiction by Brianna
Release 1 / Serial number 250901 / Inform 7 v10.1.2 / D

Dorm Room
You are sitting in your dorm room on your bed in the small apartment you share with 2 other roommates. This room is small and cozy. You see a desk in the corner of the room. On the desk is a laptop.

>turn on the laptop
It isn't something you can switch.

* * *

laptop has no description.
trash can has no description.
sink has no description.
dishes has no description.

Morgana
An Interactive Fiction by Brianna
Release 1 / Serial number 250901 / Inform 7 v10.1.2 / D

Dorm Room
You are sitting in your dorm room on your bed in the small apartment you share with 2 other roommates. This room is small and cozy. You see a desk in the corner of the room. On the desk is a laptop.

>x bed
You can't see any such thing.

>x desk
You can't see any such thing.

>examine desk
You can't see any such thing.

* * *

laptop has no description.
trash can has no description.
sink has no description.
dishes has no description.

Morgana
An Interactive Fiction by Brianna
Release 1 / Serial number 250901 / Inform 7 v10.1.2 / D

Dorm Room
You are sitting in your dorm room on your bed in the small apartment you share with 2 other roommates. This room is small and cozy. You see a desk in the corner of the room. On the desk is a laptop.

>x desk
The wooden desk came with the room.

* * *

laptop has no description.
trash can has no description.
sink has no description.
dishes has no description.

Morgana
An Interactive Fiction by Brianna
Release 1 / Serial number 250901 / Inform 7 v10.1.2 / D

Dorm Room
You are sitting in your dorm room on your bed in the small apartment you share with 2 other roommates. This room is small and cozy. You see a desk in the corner of the room. On the desk is a laptop.

>x rug
A heart shaped shag rug lays in the middle of the floor. It's nice and fluffy compared to the felt-like carpet in the rest of the room.

* * *

laptop has no description.
trash can has no description.
sink has no description.
dishes has no description.

Morgana
An Interactive Fiction by Brianna
Release 1 / Serial number 250901 / Inform 7 v10.1.2 / D

Dorm Room
You are sitting in your dorm room on your bed in the small apartment you share with 2 other roommates. This room is small and cozy. You see a desk in the corner of the room. On the desk is a laptop.

>x self
You are Morgana, a college student.

>z watch
I only understood you as far as wanting to wait.

>x watch
It is 9:01 am.

>wait
Time passes.

>x watch
It is 9:03 am.

>x watch
It is 9:04 am.

>x watch
It is 9:05 am.

>x watch
It is 9:06 am.

* * *

laptop has no description.
trash can has no description.
sink has no description.
dishes has no description.

Morgana
An Interactive Fiction by Brianna
Release 1 / Serial number 250901 / Inform 7 v10.1.2 / D

Dorm Room
You are sitting in your dorm room on your bed in the small apartment you share with 2 other roommates. This room is small and cozy. You see a desk in the corner of the room. On the desk is a laptop.

>x window
You can't see any such thing.