You are Morgana, a college student struggling to meet your project deadline, keep up with your responsibilities and try to have some kind of social life. Your project is due Friday at 11:59pm. Good luck!

Morgana
An Interactive Fiction by Brianna
Release 1 / Serial number 250917 / Inform 7 v10.1.2 / D

Dorm Room
You are sitting in your dorm room on your bed in the small apartment you share with 2 other roommates. This room is small and cozy. You see a desk in the corner of the room. On the desk is a laptop.

I beg your pardon?

* * *

You are Morgana, a college student struggling to meet your project deadline, keep up with your responsibilities and try to have some kind of social life. Your project is due Friday at 11:59pm. Good luck!

Morgana
An Interactive Fiction by Brianna
Release 1 / Serial number 250917 / Inform 7 v10.1.2 / D

Dorm Room
You are sitting in your dorm room on your bed in the small apartment you share with 2 other roommates. This room is small and cozy. You see a desk in the corner of the room. On the desk is a laptop.

>[enter]
Morgana
An Interactive Fiction by Brianna
Release 1 / Serial number 250911 / Inform 7 v10.1.2 / D

Dorm Room
You are sitting in your dorm room on your bed in the small apartment you share with 2 other roommates. This room is small and cozy. You see a desk in the corner of the room. On the desk is a laptop.

>take laptop
Taken.

>work on laptop
You should probably turn the laptop on first.

>turn on laptop
You press the power button. The laptop whirs to life, displaying your login screen.

>work on laptop
You're in the final stretch now, polishing off the last details.

>work on laptop
You're in the final stretch now, polishing off the last details.

>work on laptop
You lean back and close the laptop. The project is finally complete!

it's time for bed!

>work on laptop
You lean back and close the laptop. The project is finally complete!

* * *

>[enter]
Morgana
An Interactive Fiction by Brianna
Release 1 / Serial number 250911 / Inform 7 v10.1.2 / D

Dorm Room
You are sitting in your dorm room on your bed in the small apartment you share with 2 other roommates. This room is small and cozy. You see a desk in the corner of the room. On the desk is a laptop.

>turn on laptop
You turn on the laptop and find your progress right where you left it. It's 80 percent done.

>work
I didn't understand that sentence.

>work on project
You're in the final stretch, just a little more to go!

>work on project
You are finally done. You can relax, celebrate, or party til Saturday.

>work on project
You are finally done. You can relax, celebrate, or party til Saturday.

* * *

You are Morgana, a college student struggling to meet your project deadline, keep up with your responsibilities and try to have some kind of social life. Your project is due Friday at 11:59pm. Good luck!

Morgana
An Interactive Fiction by Brianna
Release 1 / Serial number 250917 / Inform 7 v10.1.2 / D

Dorm Room
You are sitting in your dorm room on your bed in the small apartment you share with 2 other roommates. This room is small and cozy. You see a desk in the corner of the room. On the desk is a laptop.

>a
That's not a verb I recognise.

>s
Hallway
A narrow hallway with a mirror, a coatrack, and several posters.

>e
Common Area
The common area contains a small couch, tv, dining table, and a kitchenette. The kitchenette has just a sink and a fridge. There is also a small trash can. There's also a coffee maker on the counter. All of the coffee cups are dirty though. There's also a pile of dishes soaking in the sink.

>s
Long Hall
A longer corridor that leads to a study hall to the east, Annie's Room to the south, and the courtyard outside to the west. On the door to your dorm there are 3 different critters with each of your names on them.

>w
Courtyard
The courtyard is a big area inside of a dome to keep the atmosphere in. The dome is clear so you can see outside to the rest of campus. You see a path to the north that leads to the gym, a path to the train station to the south, and the rest of campus to the west.

>s
Train Station
The train that leads off campus is here. You can take it eastward, to go get groceries, or westward to go to the sorority house.

>e
The minutes tick forwards.
You are at the grocery store.

* * *

>s
Hallway
A narrow hallway with a mirror, a coatrack, and several posters.

>w
Closet
A small closet with all three of our extra stuff in it.

You can see a large box (closed) here.

>e
Hallway
A narrow hallway with a mirror, a coatrack, and several posters.

>s
Bathroom
A tiny bathroom with a toilet, shower, and sink.

>take a shower
You turn on the shower and wait for the water to heat up. When it's hot, you strip and step inside. The steam fogs up the bathroom but it feels so nice on your skin. You take your time shampooing and scrubbing your body. You feel much better after showering.

* * *

You are Morgana, a college student struggling to meet your project deadline, keep up with your responsibilities and try to have some kind of social life. Your project is due Friday at 11:59pm. Good luck!

Morgana
An Interactive Fiction by Brianna
Release 1 / Serial number 250917 / Inform 7 v10.1.2 / D

Dorm Room
You are sitting in your dorm room on your bed in the small apartment you share with 2 other roommates. This room is small and cozy. You see a desk in the corner of the room. On the desk is a laptop.

>a b c d e f g
Who are you, a member of the British royal family? No one has that many names. Let's try this again.

What is your name?

>a b c d
Hi, a b c d!

Morgana
An Interactive Fiction by Brianna
Release 1 / Serial number 250904 / Inform 7 v10.1.2 / D

Dorm Room
You are sitting in your dorm room on your bed in the small apartment you share with 2 other roommates. This room is small and cozy. You see a desk in the corner of the room. On the desk is a laptop.

* * *

You are Morgana, a college student struggling to meet your project deadline, keep up with your responsibilities and try to have some kind of social life. Your project is due Friday at 11:59pm. Good luck!

Morgana
An Interactive Fiction by Brianna
Release 1 / Serial number 250917 / Inform 7 v10.1.2 / D

Dorm Room
You are sitting in your dorm room on your bed in the small apartment you share with 2 other roommates. This room is small and cozy. You see a desk in the corner of the room. On the desk is a laptop.

>aaaaaaaaaaaaaaaaaaaaaaaaaaaaaaaaaaaaaaaaaaaaaaaaaaaaaaaaaaaaaaaaaaaaaaaaaaaaaaaaaaaaaaaaaaaaaaaaaaaaaaaaaaaaaaaaaaaaaaaaaaaaaaaaaaaaaaaaaaaaaaaaaaaaaaaa
Hi, aaaaaaaaaaaaaaaaaaaaaaaaaaaaaaaaaaaaaaaaaaaaaaaaaaaaaaaaaaaaaaaaaaaaaaaaaaaaaaaaaaaaaaaaaaaaaaaaaaaaaaaaaaaaaaaaaaaaaaaaaaaaaaaaaaaaaaaaaaaaaaaaaaaaaaaa!

Morgana
An Interactive Fiction by Brianna
Release 1 / Serial number 250904 / Inform 7 v10.1.2 / D

Dorm Room
You are sitting in your dorm room on your bed in the small apartment you share with 2 other roommates. This room is small and cozy. You see a desk in the corner of the room. On the desk is a laptop.

* * *

You are Morgana, a college student struggling to meet your project deadline, keep up with your responsibilities and try to have some kind of social life. Your project is due Friday at 11:59pm. Good luck!

Morgana
An Interactive Fiction by Brianna
Release 1 / Serial number 250917 / Inform 7 v10.1.2 / D

Dorm Room
You are sitting in your dorm room on your bed in the small apartment you share with 2 other roommates. This room is small and cozy. You see a desk in the corner of the room. On the desk is a laptop.

>aaaaaaaaaaaaaaaaaaaaaaaaaaaaaaaaabbbbbbbbbbbbbbbbbbbbbbbbbbbbbbbbbbbbb
Hi, aaaaaaaaaaaaaaaaaaaaaaaaaaaaaaaaabbbbbbbbbbbbbbbbbbbbbbbbbbbbbbbbbbbbb!

Morgana
An Interactive Fiction by Brianna
Release 1 / Serial number 250904 / Inform 7 v10.1.2 / D

Dorm Room
You are sitting in your dorm room on your bed in the small apartment you share with 2 other roommates. This room is small and cozy. You see a desk in the corner of the room. On the desk is a laptop.

* * *

You are Morgana, a college student struggling to meet your project deadline, keep up with your responsibilities and try to have some kind of social life. Your project is due Friday at 11:59pm. Good luck!

Morgana
An Interactive Fiction by Brianna
Release 1 / Serial number 250917 / Inform 7 v10.1.2 / D

Dorm Room
You are sitting in your dorm room on your bed in the small apartment you share with 2 other roommates. This room is small and cozy. You see a desk in the corner of the room. On the desk is a laptop.

>brush teeth
There's no toothbrush here.

>s
Hallway
A narrow hallway with a mirror, a coatrack, and several posters.

>s
Bathroom
A tiny bathroom with a toilet, shower, and sink.

>brush teeth
You pick up your toothbrush, add some toothpaste, and brush your teeth. Afterwards, you feel fresh.

>brush teeth
You pick up your toothbrush, add some toothpaste, and brush your teeth. Afterwards, you feel fresh.

* * *

You are Morgana, a college student struggling to meet your project deadline, keep up with your responsibilities and try to have some kind of social life. Your project is due Friday at 11:59pm. Good luck!

Morgana
An Interactive Fiction by Brianna
Release 1 / Serial number 250917 / Inform 7 v10.1.2 / D

Dorm Room
You are sitting in your dorm room on your bed in the small apartment you share with 2 other roommates. This room is small and cozy. You see a desk in the corner of the room. On the desk is a laptop.

>drink coffee
You drink the dark, bitter coffee.

>drink coffee
You drink the dark, bitter coffee.

* * *

You are Morgana, a college student struggling to meet your project deadline, keep up with your responsibilities and try to have some kind of social life. Your project is due Friday at 11:59pm. Good luck!

Morgana
An Interactive Fiction by Brianna
Release 1 / Serial number 250917 / Inform 7 v10.1.2 / D

Dorm Room
You are sitting in your dorm room on your bed in the small apartment you share with 2 other roommates. This room is small and cozy. You see a desk in the corner of the room. On the desk is a laptop.

>e
You can't go that way.

>s
Hallway
A narrow hallway with a mirror, a coatrack, and several posters.

* * *

>e
Common Area
The common area contains a small couch, tv, dining table, and a kitchenette. The kitchenette has just a sink and a fridge. There is also a small trash can. There's also a coffee maker on the counter. All of the coffee cups are dirty though. There's also a pile of dishes soaking in the sink.

>e
Far Hall
A hall similar to the one outside of your door. Your two roommates have set out their jackets and shoes set out.

>n
Katie's Room
Her room is decorated with nerdy stuff. She's an architectural student and loves math.

You can see Katie's desk here.

* * *

You are Morgana, a college student struggling to meet your project deadline, keep up with your responsibilities and try to have some kind of social life. Your project is due Friday at 11:59pm. Good luck!

Morgana
An Interactive Fiction by Brianna
Release 1 / Serial number 250917 / Inform 7 v10.1.2 / D

Dorm Room
You are sitting in your dorm room on your bed in the small apartment you share with 2 other roommates. This room is small and cozy. You see a desk in the corner of the room. On the desk is a laptop.

>energy
That's not a verb I recognise.

>say energy
(to yourself)
There is no reply.

>check energy level
You can't see any such thing.

* * *

You are Morgana, a college student struggling to meet your project deadline, keep up with your responsibilities and try to have some kind of social life. Your project is due Friday at 11:59pm. Good luck!

Morgana
An Interactive Fiction by Brianna
Release 1 / Serial number 250917 / Inform 7 v10.1.2 / D

Dorm Room
You are sitting in your dorm room on your bed in the small apartment you share with 2 other roommates. This room is small and cozy. You see a desk in the corner of the room. On the desk is a laptop.

>examine bed
The twin bed is longer than the ones that you grew up sleeping on, but you were happy to buy new sheets for this next chapter in your life. Underneath it is a lockbox.

>l
Dorm Room
You are sitting in your dorm room on your bed in the small apartment you share with 2 other roommates. This room is small and cozy. You see a desk in the corner of the room. On the desk is a laptop.

You can see a lockbox (closed) here.

>open lockbox
It seems to be locked.

>s
Hallway
A narrow hallway with a mirror, a coatrack, and several posters.

* * *

>w
Closet
A small closet with all three of our extra stuff in it.

You can see a large box (closed) here.

>open box
You open the large box, revealing an old bracelet, a club flyer, a ratty purse, and an expired makeup.

>open purse
It isn't something you can open.

>examine purse
You see nothing special about the ratty purse.

>open ratty purse
It isn't something you can open.

>take purse
Taken.

>open purse
It isn't something you can open.

* * *

>examine purse
You see nothing special about the ratty purse.

>look in purse
You can't see inside, since the ratty purse is closed.

>open purse
It isn't something you can open.

* * *

>examine bed
The twin bed is longer than the ones that you grew up sleeping on, but you were happy to buy new sheets for this next chapter in your life. Underneath it is a lockbox.

>open lockbox
You can't see any such thing.

* * *

You are Morgana, a college student struggling to meet your project deadline, keep up with your responsibilities and try to have some kind of social life. Your project is due Friday at 11:59pm. Good luck!

Morgana
An Interactive Fiction by Brianna
Release 1 / Serial number 250917 / Inform 7 v10.1.2 / D

Dorm Room
You are sitting in your dorm room on your bed in the small apartment you share with 2 other roommates. This room is small and cozy. You see a desk in the corner of the room. On the desk is a laptop.

>l
Dorm Room
You are sitting in your dorm room on your bed in the small apartment you share with 2 other roommates. This room is small and cozy. You see a desk in the corner of the room. On the desk is a laptop.

>look
Dorm Room
You are sitting in your dorm room on your bed in the small apartment you share with 2 other roommates. This room is small and cozy. You see a desk in the corner of the room. On the desk is a laptop.

>look\
That's not a verb I recognise.

>look\
That's not a verb I recognise.

>look
Dorm Room
You are sitting in your dorm room on your bed in the small apartment you share with 2 other roommates. This room is small and cozy. You see a desk in the corner of the room. On the desk is a laptop.

>examine bed
The twin bed is longer than the ones that you grew up sleeping on, but you were happy to buy new sheets for this next chapter in your life.

Underneath it is a lockbox.

* * *

You are Morgana, a college student struggling to meet your project deadline, keep up with your responsibilities and try to have some kind of social life. Your project is due Friday at 11:59pm. Good luck!

Morgana
An Interactive Fiction by Brianna
Release 1 / Serial number 250917 / Inform 7 v10.1.2 / D

Dorm Room
You are sitting in your dorm room on your bed in the small apartment you share with 2 other roommates. This room is small and cozy. You see a desk in the corner of the room. On the desk is a laptop.

>look under bed
There is a forgotten lockbox under your bed.

>l
Dorm Room
You are sitting in your dorm room on your bed in the small apartment you share with 2 other roommates. This room is small and cozy. You see a desk in the corner of the room. On the desk is a laptop.

You can see a lockbox here.

>open lockbox
It isn't something you can open.

* * *

You are Morgana, a college student struggling to meet your project deadline, keep up with your responsibilities and try to have some kind of social life. Your project is due Friday at 11:59pm. Good luck!

Morgana
An Interactive Fiction by Brianna
Release 1 / Serial number 250917 / Inform 7 v10.1.2 / D

Dorm Room
You are sitting in your dorm room on your bed in the small apartment you share with 2 other roommates. This room is small and cozy. You see a desk in the corner of the room. On the desk is a laptop.

>open lockbox
It seems to be locked.

* * *

You are Morgana, a college student struggling to meet your project deadline, keep up with your responsibilities and try to have some kind of social life. Your project is due Friday at 11:59pm. Good luck!

Morgana
An Interactive Fiction by Brianna
Release 1 / Serial number 250917 / Inform 7 v10.1.2 / D

Dorm Room
You are sitting in your dorm room on your bed in the small apartment you share with 2 other roommates. This room is small and cozy. You see a desk in the corner of the room. On the desk is a laptop.

>s
Hallway
A narrow hallway with a mirror, a coatrack, and several posters.

>brew
I didn't understand that sentence.

* * *

>l
Common Area
The common area contains a small couch, tv, dining table, and a kitchenette. The kitchenette has just a sink and a fridge. There is also a small trash can. There's also a coffee maker on the counter. All of the coffee cups are dirty though. There's also a pile of dishes soaking in the sink.

* * *

>s
Hallway
A narrow hallway with a mirror, a coatrack, and several posters.

>brew coffee
All the mugs are dirty.

>brew coffee
All the mugs are dirty.

>drink coffe
You can't see any such thing.

>x cup
You can't see any such thing.

* * *

>brew coffee
All the mugs are dirty.

>drink coffee
Which do you mean, the cup of coffee or the coffee maker?

* * *

>brew coffee
All the mugs are dirty.

>wash dishes
You feel a little worn.
The minutes tick backwards.

>brew coffee
You have a fresh cup of coffee.

>drink coffee
(the cup of coffee)
You feel a bit more energetic.
You drink the hot coffee and it warms you from the inside.

>drink cup of coffee
You can't see any such thing.

>i
You are carrying nothing.

>i
You are carrying nothing.

>l
Common Area
The common area contains a small couch, tv, dining table, and a kitchenette. The kitchenette has just a sink and a fridge. There is also a small trash can. There's also a coffee maker on the counter. The coffee cups are clean and ready to use. There's also a pile of dishes clean and drying on the counter.

* * *

>wash dishes
You feel a little worn.
The minutes tick backwards.

>drink coffee
You can't see any such thing.

>brew coffee
You have a fresh cup of coffee.

>drink coffee
You feel a bit more energetic.
You drink the hot coffee and it warms you from the inside.

>drink coffee
You feel a bit more energetic.
You drink the hot coffee and it warms you from the inside.

* * *

>s
Hallway
A narrow hallway with a mirror, a coatrack, and several posters.

>drink coffee
You feel a bit more energetic.
You drink the dark, bitter coffee.

* * *

>s
Hallway
A narrow hallway with a mirror, a coatrack, and several posters.

>e
Common Area
The common area contains a small couch, tv, dining table, and a kitchenette. The kitchenette has just a sink and a fridge. There is also a small trash can. There's also a coffee maker on the counter. All of the coffee cups are dirty though. There's also a pile of dishes soaking in the sink.  There is a game console hooked up to the TV.

>e
Far Hall
A hall similar to the one outside of your door. Your two roommates have set out their jackets and shoes set out.

>n
Katie's Room
Her room is decorated with nerdy stuff. She's an architectural student and loves math. The same type of desk as yours. She has a laptop charger and a mousepad with equations on it. On one of the walls is a tourism poster of earth. You both hope to go there one day.

* * *

>e
Far Hall
A hall similar to the one outside of your door. Your two roommates have set out their jackets and shoes set out.

>w
Common Area
The common area contains a small couch, tv, dining table, and a kitchenette. The kitchenette has just a sink and a fridge. There is also a small trash can. There's also a coffee maker on the counter. All of the coffee cups are dirty though. There's also a pile of dishes soaking in the sink.

>s
Long Hall
A longer corridor that leads to a study hall to the east, Annie's Room to the south, and the courtyard outside to the west. On the door to your dorm there are 3 different critters with each of your names on them.

* * *

>w
Courtyard
The courtyard is a big area inside of a dome to keep the atmosphere in. The dome is clear so you can see outside to the rest of campus. You see a path to the north that leads to the gym, a path to the train station to the south, and the rest of campus to the west.

>w
Sidewalk
A long stretch from the courtyard to the building where your professor's office is. The walk is nice and peaceful.

>w
Professor's Office
You walk into your professor's office. She is there, grading homework assignments. She welcomes you in. You ask her some questions about the final project, and feel that you understand what to do better.

>e
Sidewalk
A long stretch from the courtyard to the building where your professor's office is. The walk is nice and peaceful.

>e
Courtyard
The courtyard is a big area inside of a dome to keep the atmosphere in. The dome is clear so you can see outside to the rest of campus. You see a path to the north that leads to the gym, a path to the train station to the south, and the rest of campus to the west.

>e
Long Hall
A longer corridor that leads to a study hall to the east, Annie's Room to the south, and the courtyard outside to the west. On the door to your dorm there are 3 different critters with each of your names on them.

>m
That's not a verb I recognise.

>n
Common Area
The common area contains a small couch, tv, dining table, and a kitchenette. The kitchenette has just a sink and a fridge. There is also a small trash can. There's also a coffee maker on the counter. All of the coffee cups are dirty though. There's also a pile of dishes soaking in the sink.

>w
Hallway
A narrow hallway with a mirror, a coatrack, and several posters.

>n
Dorm Room
You are sitting in your dorm room on your bed in the small apartment you share with 2 other roommates. This room is small and cozy. You see a desk in the corner of the room. On the desk is a laptop.

>turn on laptop
You turn on the laptop and find your project right where you left it. It's 0 percent done.

>work on laptop
You feel a little worn.
The minutes tick forwards.

You're almost halfway there. You definitely have momentum now.

>work on laptop
You feel a little worn.
The minutes tick forwards.

You're in the final stretch, just a little more to go!

>work on laptop
You feel a little worn.
The minutes tick forwards.

You are finally done. You can relax, celebrate, or party til Saturday. Enjoy your time.

* * *

>e
Common Area
The common area contains a small couch, tv, dining table, and a kitchenette. The kitchenette has just a sink and a fridge. There is also a small trash can. There's also a coffee maker on the counter. All of the coffee cups are dirty though. There's also a pile of dishes soaking in the sink.  There is a game console hooked up to the TV.

>play gamesphere
You get lost playing the the game and zone back into reality several hours later.

* * *

>e
Common Area
The common area contains a small couch, tv, dining table, and a kitchenette. The kitchenette has just a sink and a fridge. There is also a small trash can. There's also a coffee maker on the counter. All of the coffee cups are dirty though. There's also a pile of dishes soaking in the sink.  There is a game console hooked up to the TV.

>s
Long Hall
A longer corridor that leads to a study hall to the east, Annie's Room to the south, and the courtyard outside to the west. On the door to your dorm there are 3 different critters with each of your names on them.

* * *

>s
Train Station
The train that leads off campus is here. You can take it eastward, to go get groceries, or westward to go to the sorority house.

>e
The minutes tick forwards.

Grocery Store
The local grocer carries cheap and easy meals. You fill your basket, check out, and are ready to go back home. Take the train west to go back to campus

>w
Train Station
The train that leads off campus is here. You can take it eastward, to go get groceries, or westward to go to the sorority house.

>w
Sorority House
A big fancy building with greek letters on the outside. Once you go inside, there are about 35 sorority girls all drinking and having fun. You also see Annie. Do you want to join them?

>e
Train Station
The train that leads off campus is here. You can take it eastward, to go get groceries, or westward to go to the sorority house.

>e
The minutes tick forwards.

>e
You can't go that way.

>e
You can't go that way.

>l
Grocery Store
The local grocer carries cheap and easy meals. You fill your basket, check out, and are on your way back home.

* * *

>s
Train Station
The train that leads off campus is here. You can take it eastward, to go get groceries, or westward to go to the sorority house.

>w
The minutes tick forwards.

Sorority House
A big fancy building with greek letters on the outside. Once you go inside, there are about 35 sorority girls all drinking and having fun. You also see Annie. You join the party and have a good time.

* * *

>e
Long Hall
A longer corridor that leads to a study hall to the east, Annie's Room to the south, and the courtyard outside to the west. On the door to your dorm there are 3 different critters with each of your names on them.

>n
Common Area
The common area contains a small couch, tv, dining table, and a kitchenette. The kitchenette has just a sink and a fridge. There is also a small trash can. There's also a coffee maker on the counter. All of the coffee cups are dirty though. There's also a pile of dishes soaking in the sink.

* * *

>w
Hallway
A narrow hallway with a mirror, a coatrack, and several posters.

I beg your pardon?

>n
Dorm Room
You are sitting in your dorm room on your bed in the small apartment you share with 2 other roommates. This room is small and cozy. You see a desk in the corner of the room. On the desk is a laptop.

* * *

>turn on laptop
You turn on the laptop and find your project right where you left it. It's 0 percent done.

>work on project
You feel a little worn.
The minutes tick forwards.

You're almost halfway there. You definitely have momentum now.

>work on project
You feel a little worn.
The minutes tick forwards.

You're in the final stretch, just a little more to go!

>work on project
You feel a little worn.
The minutes tick forwards.

You are finally done. You can relax, celebrate, or party til Saturday. Enjoy your time.

You neglected your own needs too much and need to be hospitalized. You missed your project deadline and also have a hefty medical bill to deal with.

    *** The End ***

Would you like to RESTART, RESTORE a saved game, QUIT, or UNDO the last command?

* * *

>e
Common Area
The common area contains a small couch, tv, dining table, and a kitchenette. The kitchenette has just a sink and a fridge. There is also a small trash can. There's also a coffee maker on the counter. All of the coffee cups are dirty though. There's also a pile of dishes soaking in the sink.  There is a game console hooked up to the TV.

>wash dishes
You feel a little worn.
The minutes tick backwards.

>wash dishes
but they're already clean.

* * *

>look
Common Area
The common area contains a small couch, tv, dining table, and a kitchenette. The kitchenette has just a sink and a fridge. There is also a small trash can. There's also a coffee maker on the counter. All of the coffee cups are dirty though. There's also a pile of dishes soaking in the sink.  There is a game console hooked up to the TV.

* * *

>s
Hallway
A narrow hallway with a mirror, a coatrack, and several posters.

>examine trash can
You can't see any such thing.

>x trash
You can't see any such thing.

>x can
You can't see any such thing.

* * *

>s
Hallway
A narrow hallway with a mirror, a coatrack, and several posters.

>make coffee
That's not a verb I recognise.

* * *

>s
Hallway
A narrow hallway with a mirror, a coatrack, and several posters.

>n
Dorm Room
You are sitting in your dorm room on your bed in the small apartment you share with 2 other roommates. This room is small and cozy. You see a desk in the corner of the room. On the desk is a laptop.

>s
common area
The common area contains a small couch, tv, dining table, and a kitchenette. The kitchenette has just a sink and a fridge.

The trash can is barely full.

You can also see a cup of coffee here.

>wash dishes
The dishes are now pretty and clean!

* * *

>n
Dorm Room
You are sitting in your dorm room on your bed in the small apartment you share with 2 other roommates. This room is small and cozy. You see a desk in the corner of the room. On the desk is a laptop.

>work
I didn't understand that sentence.

>work on laptop
You should probably turn the laptop on first.

>turn on laptop
You turn on the laptop and find your project right where you left it. It's 0 percent done.

>work on project
You feel a little worn.

You spend some time working on the project. You're making progress.

>s
Hallway
A narrow hallway with a mirror, a coatrack, and several posters.

* * *

>w
Courtyard
The courtyard is a big area inside of a dome to keep the atmosphere in. The dome is clear so you can see outside to the rest of campus. You see a path to the north that leads to the gym, a path to the train station to the south, and the rest of campus to the west.

>n
Gym
A modest sized gym that is free for students. You're too tired to work out right now.

* * *

>brush teeth
You pick up your toothbrush, add some toothpaste, and brush your teeth. Afterwards, you feel fresh.

>n
Hallway
A narrow hallway with a mirror, a coatrack, and several posters.

>e
Common Area
The common area contains a small couch, tv, dining table, and a kitchenette. The kitchenette has just a sink and a fridge. There is also a small trash can. There's also a coffee maker on the counter. All of the coffee cups are dirty though. There's also a pile of dishes soaking in the sink.  There is a game console hooked up to the TV.

>wash dishes
You feel a little worn.

>s
Long Hall
A longer corridor that leads to a study hall to the east, Annie's Room to the south, and the courtyard outside to the west. On the door to your dorm there are 3 different critters with each of your names on them.

>n
Common Area
The common area contains a small couch, tv, dining table, and a kitchenette. The kitchenette has just a sink and a fridge. There is also a small trash can. There's also a coffee maker on the counter. The coffee cups are clean and ready to use. There's also a pile of dishes clean and drying on the counter. There is a game console hooked up to the TV.

>w
Hallway
A narrow hallway with a mirror, a coatrack, and several posters.

>s
Bathroom
A tiny bathroom with a toilet, shower, and sink.

>n
Hallway
A narrow hallway with a mirror, a coatrack, and several posters.

>e
Common Area
The common area contains a small couch, tv, dining table, and a kitchenette. The kitchenette has just a sink and a fridge. There is also a small trash can. There's also a coffee maker on the counter. All of the coffee cups are dirty though. There's also a pile of dishes soaking in the sink.

* * *

>s
Train Station
The train that leads off campus is here. You can take it eastward, to go get groceries, or westward to go to the sorority house.

>e
The minutes tick forwards.

Train Station
The train that leads off campus is here. You can take it eastward, to go get groceries, or westward to go to the sorority house.

>e
The minutes tick forwards.

Train Station
The train that leads off campus is here. You can take it eastward, to go get groceries, or westward to go to the sorority house.

* * *

>take a shower
You turn on the shower and wait for the water to heat up. When it's hot, you strip and step inside. The steam fogs up the bathroom but it feels so nice on your skin. You take your time shampooing and scrubbing your body. You feel much better after showering.

>n
Hallway
A narrow hallway with a mirror, a coatrack, and several posters.

>n
Dorm Room
You are sitting in your dorm room on your bed in the small apartment you share with 2 other roommates. This room is small and cozy. You see a desk in the corner of the room. On the desk is a laptop.

>work on project
You feel a little worn.

You're almost halfway there. You definitely have momentum now.

>work on project
You feel a little worn.

You're almost halfway there. You definitely have momentum now.

>s
Hallway
A narrow hallway with a mirror, a coatrack, and several posters.

* * *

>s
Bathroom
A tiny bathroom with a toilet, shower, and sink.

>wash dishes
You feel a little worn.
The minutes tick backwards.

* * *

>w
Closet
A small closet with all three of our extra stuff in it.

You can see a large box (closed) here.

>open boc
You can't see any such thing.

>open box
You open the large box, revealing an old bracelet, a club flyer, a ratty purse, and an expired makeup.

* * *

>open purse
It isn't something you can open.

>look in purse
In the ratty purse is a square key.

>take key
Taken.

>examine key
You completely forgot where you put this key!

If only you remembered what it went to.

* * *

>open box
You open the large box, revealing an old bracelet, a club flyer, a ratty purse, and an expired makeup.

>examine purse
An old pleather bag that carried you for the last 3 years. You retired it several months ago but kept it because it still holds sentimental value.

In the ratty purse is a square key.

>take key
Taken.

>e
Hallway
A narrow hallway with a mirror, a coatrack, and several posters.

>n
Dorm Room
You are sitting in your dorm room on your bed in the small apartment you share with 2 other roommates. This room is small and cozy. You see a desk in the corner of the room. On the desk is a laptop.

>examine bed
The twin bed is longer than the ones that you grew up sleeping on, but you were happy to buy new sheets for this next chapter in your life. Underneath it is a lockbox.

>open lockbox with key
You unlock the lockbox.

>open lockbox
You open the lockbox.

>look in lockbox
The lockbox is empty.

* * *

>n
Dorm Room
You are sitting in your dorm room on your bed in the small apartment you share with 2 other roommates. This room is small and cozy. You see a desk in the corner of the room. On the desk is a laptop.

>look under bed
There is a forgotten lockbox under your bed.

>unlock lockbox
(with the square key)
You unlock the lockbox.

>open lockbox
You open the lockbox, revealing a badderall.

>take badderall
Taken.

>examine badderall
A sketchy drug that you got at a fuel station last week. The packaging says that it gives you plenty of energy with no side effects.

>turn on laptop
You turn on the laptop and find your project right where you left it. It's 0 percent done.

>work on project
You feel a little worn.
The minutes tick forwards.

You spend some time working on the project. You're making progress.

>work on project
You feel a little worn.
The minutes tick forwards.

You're almost halfway there. You definitely have momentum now.

>work on project
You feel a little worn.
The minutes tick forwards.

You're almost halfway there. You definitely have momentum now.

* * *

>open box
You open the large box, revealing an old bracelet, a club flyer, a ratty purse, and an expired makeup.

>get key
Taken.

>e
Hallway
A narrow hallway with a mirror, a coatrack, and several posters.

* * *

>n
Dorm Room
You are sitting in your dorm room on your bed in the small apartment you share with 2 other roommates. This room is small and cozy. You see a desk in the corner of the room. On the desk is a laptop.

>look under bec
You can't see any such thing.

>look under bed
There is a forgotten lockbox under your bed.

>unlock and open lockboc
You can't see any such thing.

>unlock and open lockbox
You can't see any such thing.

>unlock lockbox
(with the square key)
You unlock the lockbox.

* * *

>take badderall
Taken.

>turn on laptop
You turn on the laptop and find your project right where you left it. It's 0 percent done.

>work on laptop
You feel a little worn.
The minutes tick forwards.

You spend some time working on the project. You're making progress.

>work on laptop
You feel a little worn.
The minutes tick forwards.

You spend some time working on the project. You're making progress.

>work on laptop
You feel a little worn.
The minutes tick forwards.

You're almost halfway there. You definitely have momentum now.

>work on laptop
You feel a little worn.
The minutes tick forwards.

You're almost halfway there. You definitely have momentum now.

* * *

>work on laptop
You feel a little worn.
The minutes tick forwards.

You're in the final stretch, just a little more to go!

>take addreall
You can't see any such thing.

>take baddreall
You can't see any such thing.

* * *

>open box
You open the large box, revealing an old bracelet, a club flyer, a ratty purse, and an expired makeup.

>open large box
It isn't something you can open.

>l
Closet
A small closet with all three of our extra stuff in it.

You can see a large box (closed) here.

>open the box
It isn't something you can open.

* * *

>w
Closet
A small closet with all three of our extra stuff in it.

You can see a large box (closed) here.

>open large box
It isn't something you can open.

* * *

>s
Hallway
A narrow hallway with a mirror, a coatrack, and several posters.

>wash dishes
You feel a little worn.
The minutes tick backwards.

* * *

>brew coffee
You have a fresh cup of coffee.

>drink coffee
You drink the hot coffee and it warms you from the inside.
You feel a bit more energetic.

>brew coffee
You have a fresh cup of coffee.

>drink coffee
You drink the hot coffee and it warms you from the inside.

>brew coffee
You have a fresh cup of coffee.

>drink coffee
You drink the hot coffee and it warms you from the inside.

    *** Your body couldn't take it. You evaporate into a cloud of red mist. You died, RIP ***

Would you like to RESTART, RESTORE a saved game, QUIT, or UNDO the last command?

>brew coffee
You have a fresh cup of coffee.

>drink coffee\
You can't see any such thing.

>brew coffee
You have a fresh cup of coffee.

* * *

>drink coffee
You drink the hot coffee and it warms you from the inside.
You feel a bit more energetic.

>drink coffee
You can't see any such thing.

* * *

>drink coffee
You feel a bit more energetic.
You drink the hot coffee and it warms you from the inside.

>brew coffee
You have a fresh cup of coffee.

* * *

>drink coffee
You can't see any such thing.

>l
Common Area
The common area contains a small couch, tv, dining table, and a kitchenette. The kitchenette has just a sink and a fridge. There is also a small trash can. There's also a coffee maker on the counter. The coffee cups are clean and ready to use. There's also a pile of dishes clean and drying on the counter.

* * *

>wash dishes
You feel a little worn.
The minutes tick backwards.

>drink coffee
You feel a bit more energetic.
You drink the hot coffee and it warms you from the inside.

>drink coffee
You drink the dark, bitter coffee.

* * *

>drink coffee
You feel a bit more energetic.
You drink the hot coffee and it warms you from the inside.

>wash dishes
but they're already clean.

>wash dishes
but they're already clean.

>x dishes
A few plates, cereal bowls, and spoons.
They are clean and drying on the countertop.

* * *

>wash dishes
You feel a little worn.
The minutes tick backwards.

>l
Common Area
The common area contains a small couch, tv, dining table, and a kitchenette. The kitchenette has just a sink and a fridge. There is also a small trash can. There's also a coffee maker on the counter. The coffee cups are clean and ready to use. There's also a pile of dishes clean and drying on the counter.

>make coffee
That's not a verb I recognise.

* * *

>l
Common Area
The common area contains a small couch, tv, dining table, and a kitchenette. The kitchenette has just a sink and a fridge. There is also a small trash can. There's also a coffee maker on the counter. The coffee cups are clean and ready to use. There's also a pile of dishes clean and drying on the counter.

>x dishes
You see nothing special about the pile of dishes.

A few plates, cereal bowls, and spoons.
They are clean and drying on the countertop.

* * *

>wash dishes
You feel a little worn.
The minutes tick backwards.

>look
Common Area
The common area contains a small couch, tv, dining table, and a kitchenette. The kitchenette has just a sink and a fridge. There is also a small trash can. There's also a coffee maker on the counter. The coffee cups are clean and ready to use.

You can see a pile of dishes and a cup of coffee here.

* * *

>wash dishes
You feel a little worn.
The minutes tick backwards.

>make coffee
That's not a verb I recognise.

>brew coffee
there's fresh coffee now.

>drink coffee
There's nothing suitable to drink here.

* * *

>wash dishes
You feel a little worn.
The minutes tick backwards.

>wash dishes
You're too tired to do that.

>wash dishes
You're too tired to do that.

>drink coffee
You feel a bit more energetic.
You drink the hot coffee and it warms you from the inside.

>wash dishes
You feel a little worn.
The minutes tick backwards.

* * *

>wash dishes
You're too tired to do that.

>wash dishes
You don't have the energy to do much else.

>SHOWME
common area - room
    yourself - person
    sink - open container
        dishes
    cup of coffee

>drink coffee
You feel a bit more energetic.
You drink the dark, bitter coffee.

>drink coffee
You feel a bit more energetic.
You drink the dark, bitter coffee.

>wash dishes
You feel a little drained.

* * *

>wash dishes
You don't have the energy to do much else.

>wash dishes
You don't have the energy to do much else.

* * *

>wash dishes
You're too tired to do that.

>wash dishes\
You can't see any such thing.

>wash dishes\
You can't see any such thing.

>wash dishes
You don't have the energy to do much else.

* * *

>s
Hallway
A narrow hallway with a mirror, a coatrack, and several posters.

>x coffee
You can't see any such thing.

>wash dishes
You feel a little worn.
The minutes tick backwards.

* * *

>wash dishes
but they're already clean.

>brew coffee
You have a fresh cup of coffee.

>x coffee
A warm cup of fresh hot coffee. The outside reads "#1 Mug"

* * *

>s
Hallway
A narrow hallway with a mirror, a coatrack, and several posters.

>x dishes
A few coffee cups, cereal bowls, and spoons. They are covered in greasy stains and leftover food and have been here for a few days.

>wash dishes
You feel a little worn.
The minutes tick backwards.

>x dishes
A few coffee cups, cereal bowls, and spoons.

They are clean and drying on the countertop.

>wash dishes
You're too tired to do that.

* * *

>examine trash can
You can't see any such thing.

* * *

>look
Common Area
The common area contains a small couch, tv, dining table, and a kitchenette. The kitchenette has just a sink and a fridge. There is also a small trash can. There's also a coffee maker on the counter. All of the coffee cups are dirty though. There's also a pile of dishes soaking in the sink.

>z
Time passes.

>z
Time passes.

I beg your pardon?

>z
Time passes.

* * *

>x trash can
The trash can is empty.

>x trash can
The trash can is empty.

I beg your pardon?

I beg your pardon?

>x trash can
The trash can is empty.

* * *

>s
Hallway
A narrow hallway with a mirror, a coatrack, and several posters.

>z
Time passes.

>x trash can
The trash can is empty.

That's where you belong

* * *

You are Morgana, a college student struggling to meet your project deadline, keep up with your responsibilities and try to have some kind of social life. Your project is due Friday at 11:59pm. Good luck!

Morgana
An Interactive Fiction by Brianna
Release 1 / Serial number 250917 / Inform 7 v10.1.2 / D

Dorm Room
You are sitting in your dorm room on your bed in the small apartment you share with 2 other roommates. This room is small and cozy. You see a desk in the corner of the room. On the desk is a laptop.

>sandy
Hi, sandy!

Morgana
An Interactive Fiction by Brianna
Release 1 / Serial number 250904 / Inform 7 v10.1.2 / D

Dorm Room
You are sitting in your dorm room on your bed in the small apartment you share with 2 other roommates. This room is small and cozy. You see a desk in the corner of the room. On the desk is a laptop.

>cheeks
That's not a verb I recognise.

* * *

You are Morgana, a college student struggling to meet your project deadline, keep up with your responsibilities and try to have some kind of social life. Your project is due Friday at 11:59pm. Good luck!

Morgana
An Interactive Fiction by Brianna
Release 1 / Serial number 250917 / Inform 7 v10.1.2 / D

Dorm Room
You are sitting in your dorm room on your bed in the small apartment you share with 2 other roommates. This room is small and cozy. You see a desk in the corner of the room. On the desk is a laptop.

>shower
That's not a verb I recognise.

>take a shower
You turn on the shower and wait for the water to heat up. When it's hot, you strip and step inside. The steam fogs up the bathroom but it feels so nice on your skin. You take your time shampooing and scrubbing your body. You feel much better after showering.

* * *

You are Morgana, a college student struggling to meet your project deadline, keep up with your responsibilities and try to have some kind of social life. Your project is due Friday at 11:59pm. Good luck!

Morgana
An Interactive Fiction by Brianna
Release 1 / Serial number 250917 / Inform 7 v10.1.2 / D

Dorm Room
You are sitting in your dorm room on your bed in the small apartment you share with 2 other roommates. This room is small and cozy. You see a desk in the corner of the room. On the desk is a laptop.

>showering
That's not a verb I recognise.

* * *

You are Morgana, a college student struggling to meet your project deadline, keep up with your responsibilities and try to have some kind of social life. Your project is due Friday at 11:59pm. Good luck!

Morgana
An Interactive Fiction by Brianna
Release 1 / Serial number 250917 / Inform 7 v10.1.2 / D

Dorm Room
You are sitting in your dorm room on your bed in the small apartment you share with 2 other roommates. This room is small and cozy. You see a desk in the corner of the room. On the desk is a laptop.

>skip
You jump on the spot.

>skipping
That's not a verb I recognise.

* * *

You are Morgana, a college student struggling to meet your project deadline, keep up with your responsibilities and try to have some kind of social life. Your project is due Friday at 11:59pm. Good luck!

Morgana
An Interactive Fiction by Brianna
Release 1 / Serial number 250917 / Inform 7 v10.1.2 / D

Dorm Room
You are sitting in your dorm room on your bed in the small apartment you share with 2 other roommates. This room is small and cozy. You see a desk in the corner of the room. On the desk is a laptop.

>stall
The minutes tick forwards.
A while passes...

>stall
The minutes tick forwards.
A while passes...

>stall
The minutes tick forwards.
A while passes...

It's time for bed! You wake up the next day fully rested.

>stall
The minutes tick forwards.
A while passes...

>stall
The minutes tick forwards.
A while passes...

You neglected your own needs too much and need to be hospitalized. You missed your project deadline and also have a hefty medical bill to deal with.

    *** The End ***

Would you like to RESTART, RESTORE a saved game, QUIT, or UNDO the last command?

* * *

>stall
The minutes tick forwards.
A while passes...

>z
Time passes.

>z
Time passes.

Your chores are starting to pile up. You might want to take care of some stuff.

>z
Time passes.

Your chores are starting to pile up. You might want to take care of some stuff.

>z
Time passes.

You neglected your own needs too much and need to be hospitalized. You missed your project deadline and also have a hefty medical bill to deal with.

    *** The End ***

Would you like to RESTART, RESTORE a saved game, QUIT, or UNDO the last command?

* * *

You are Morgana, a college student struggling to meet your project deadline, keep up with your responsibilities and try to have some kind of social life. Your project is due Friday at 11:59pm. Good luck!

Morgana
An Interactive Fiction by Brianna
Release 1 / Serial number 250917 / Inform 7 v10.1.2 / D

Dorm Room
You are sitting in your dorm room on your bed in the small apartment you share with 2 other roommates. This room is small and cozy. You see a desk in the corner of the room. On the desk is a laptop.

>take a shower
There's no shower here.

>e
You can't go that way.

* * *

You are Morgana, a college student struggling to meet your project deadline, keep up with your responsibilities and try to have some kind of social life. Your project is due Friday at 11:59pm. Good luck!

Morgana
An Interactive Fiction by Brianna
Release 1 / Serial number 250917 / Inform 7 v10.1.2 / D

Dorm Room
You are sitting in your dorm room on your bed in the small apartment you share with 2 other roommates. This room is small and cozy. You see a desk in the corner of the room. On the desk is a laptop.

>turn on
What do you want to turn on?

>turn on laptop
You turn on the laptop and find your project right where you left it. It's 0 percent done.

* * *

>work on laptop
You feel a little worn.
The minutes tick forwards.

You're almost halfway there. You definitely have momentum now.

>work on laptop
You're too tired to do that.

You're in the final stretch, just a little more to go!

>work on laptop
That's about all the effort you feel like putting in today.
The minutes tick backwards.

You're in the final stretch, just a little more to go!

>work on laptop
oops too tired :(

>work on laptop
oops too tired :(

* * *

You are Morgana, a college student struggling to meet your project deadline, keep up with your responsibilities and try to have some kind of social life. Your project is due Friday at 11:59pm. Good luck!

Morgana
An Interactive Fiction by Brianna
Release 1 / Serial number 250917 / Inform 7 v10.1.2 / D

Dorm Room
You are sitting in your dorm room on your bed in the small apartment you share with 2 other roommates. This room is small and cozy. You see a desk in the corner of the room. On the desk is a laptop.

>turn on laptop
You turn on the laptop and find your project right where you left it. It's 0 percent done.

>play laptop
The minutes tick forwards.
You get lost playing the the laptop and zone back into reality several hours later

>play bed
The minutes tick forwards.
You get lost playing the the bed and zone back into reality several hours later

>s
Hallway
A narrow hallway with a mirror, a coatrack, and several posters.

* * *

>e
Common Area
The common area contains a small couch, tv, dining table, and a kitchenette. The kitchenette has just a sink and a fridge. There is also a small trash can. There's also a coffee maker on the counter. All of the coffee cups are dirty though. There's also a pile of dishes soaking in the sink.  There is a game console hooked up to the TV.

>play game
The minutes tick forwards.
You get lost playing the the game and zone back into reality several hours later

* * *

>turn on laptop
You turn on the laptop and find your project right where you left it. It's 0 percent done.

>work
I didn't understand that sentence.

>work on laptop
You feel a little worn.
The minutes tick forwards.

You spend some time working on the project. You're making progress.

* * *

>work on laptop
You feel a little worn.
The minutes tick forwards.

You're in the final stretch, just a little more to go!

>work on laptop
You're too tired to do that.

You're in the final stretch, just a little more to go!

* * *

>turn on laptop
You turn on the laptop and find your project right where you left it. It's 0 percent done.

>work on laptop
oops too tired :(

>work on laptop
You feel a little worn.
The minutes tick forwards.

You're almost halfway there. You definitely have momentum now.

>work on laptop
You're too tired to do that.

You're almost halfway there. You definitely have momentum now.

>work on laptop
That's about all the effort you feel like putting in today.
The minutes tick backwards.

You're in the final stretch, just a little more to go!

>work on laptop
You're almost halfway there. You definitely have momentum now.

it's time for bed!

* * *

>work on project
You feel a little worn.
The minutes tick forwards.

You're in the final stretch, just a little more to go!

>work on project
You feel a little worn.
The minutes tick forwards.

You're in the final stretch, just a little more to go!

>stall
The minutes tick forwards.
A while passes...

>stall
The minutes tick forwards.
A while passes...

it's time for bed!

* * *

>work on project
You feel a little worn.
The minutes tick forwards.

You're in the final stretch, just a little more to go!

>work on project
oops too tired :(

>work on project
oops too tired :(

>dskip
The time has come to turn in your final project. Your grade is....
A! You're on track to become the smartest mind of your generation! Feel proud of your accomplishment and enjoy your time off before the next ovester starts.

    *** The End ***

Would you like to RESTART, RESTORE a saved game, QUIT, or UNDO the last command?

* * *

>work on project
oops too tired :(

>look under bed
There is a forgotten lockbox under your bed.

>open lockbox
It seems to be locked.

>unlock lockbox
(with the laptop)
That doesn't seem to fit the lock.

>dskip
The time has come to turn in your final project. Your grade is....
F for the failure you are :(

    *** The End ***

Would you like to RESTART, RESTORE a saved game, QUIT, or UNDO the last command?

* * *

>work on project
oops too tired :(

>s
Common Area
The common area contains a small couch, tv, dining table, and a kitchenette. The kitchenette has just a sink and a fridge. There is also a small trash can. There's also a coffee maker on the counter. All of the coffee cups are dirty though. There's also a pile of dishes soaking in the sink.

>wash dishes
You're too tired to do that.

>brew coffee
You have a fresh cup of coffee.

* * *

>drink coffee
You drink the hot coffee and it warms you from the inside.
You feel a bit more energetic.

>n
Dorm Room
You are sitting in your dorm room on your bed in the small apartment you share with 2 other roommates. This room is small and cozy. You see a desk in the corner of the room. On the desk is a laptop.

>work on project
You feel a little worn.
The minutes tick forwards.

You are finally done. You can relax, celebrate, or party til Saturday. Press x to skip to Saturday, or press anything else to continue and enjoy your time. What do you do?
Have fun!

>x
What do you want to examine?

* * *

You are Morgana, a college student struggling to meet your project deadline, keep up with your responsibilities and try to have some kind of social life. Your project is due Friday at 11:59pm. Good luck!

Morgana
An Interactive Fiction by Brianna
Release 1 / Serial number 250917 / Inform 7 v10.1.2 / D

Dorm Room
You are sitting in your dorm room on your bed in the small apartment you share with 2 other roommates. This room is small and cozy. You see a desk in the corner of the room. On the desk is a laptop.

>turn on laptp
You can't see any such thing.

>turn on laptop
You turn on the laptop and find your project right where you left it. It's 0 percent done.

* * *

>work on project
You feel a little worn.
The minutes tick forwards.

You spend some time working on the project. You're making progress.

>i
You are carrying:
  a laptop

* * *

You are Morgana, a college student struggling to meet your project deadline, keep up with your responsibilities and try to have some kind of social life. Your project is due Friday at 11:59pm. Good luck!

Morgana
An Interactive Fiction by Brianna
Release 1 / Serial number 250917 / Inform 7 v10.1.2 / D

Dorm Room
You are sitting in your dorm room on your bed in the small apartment you share with 2 other roommates. This room is small and cozy. You see a desk in the corner of the room. On the desk is a laptop.

>unlock lockbox
What do you want to unlock the lockbox with?

>i
You are carrying nothing.

>s
Hallway
A narrow hallway with a mirror, a coatrack, and several posters.

>w
Closet
A small closet with all three of our extra stuff in it.

A large box containing everything you brought to college but haven't used yet.

>open box
It isn't something you can open.

* * *

You are Morgana, a college student struggling to meet your project deadline, keep up with your responsibilities and try to have some kind of social life. Your project is due Friday at 11:59pm. Good luck!

Morgana
An Interactive Fiction by Brianna
Release 1 / Serial number 250917 / Inform 7 v10.1.2 / D

Dorm Room
You are sitting in your dorm room on your bed in the small apartment you share with 2 other roommates. This room is small and cozy. You see a desk in the corner of the room. On the desk is a laptop.

>wait
Time passes.

>stall
The minutes tick forwards.
A while passes...

>stall
The minutes tick forwards.
A while passes...

It's time for bed! You wake up the next day fully rested.
The time has come to turn in your final project. Your grade is....
F for the failure you are :(

    *** The End ***

Would you like to RESTART, RESTORE a saved game, QUIT, or UNDO the last command?

* * *

You are Morgana, a college student struggling to meet your project deadline, keep up with your responsibilities and try to have some kind of social life. Your project is due Friday at 11:59pm. Good luck!

Morgana
An Interactive Fiction by Brianna
Release 1 / Serial number 250917 / Inform 7 v10.1.2 / D

Dorm Room
You are sitting in your dorm room on your bed in the small apartment you share with 2 other roommates. This room is small and cozy. You see a desk in the corner of the room. On the desk is a laptop.

>work on laptop
You should probably turn the laptop on first.

>turn on laptop
You turn on the laptop and find your progress right where you left it. It's 80 percent done.

>work on laptop
You're in the final stretch, just a little more to go!

* * *

You are Morgana, a college student struggling to meet your project deadline, keep up with your responsibilities and try to have some kind of social life. Your project is due Friday at 11:59pm. Good luck!

Morgana
An Interactive Fiction by Brianna
Release 1 / Serial number 250917 / Inform 7 v10.1.2 / D

Dorm Room
You are sitting in your dorm room on your bed in the small apartment you share with 2 other roommates. This room is small and cozy. You see a desk in the corner of the room. On the desk is a laptop.

>xyzzy
Nice try bozo.

* * *

You are Morgana, a college student struggling to meet your project deadline, keep up with your responsibilities and try to have some kind of social life. Your project is due Friday at 11:59pm. Good luck!

Morgana
An Interactive Fiction by Brianna
Release 1 / Serial number 250917 / Inform 7 v10.1.2 / D

Dorm Room
You are sitting in your dorm room on your bed in the small apartment you share with 2 other roommates. This room is small and cozy. You see a desk in the corner of the room. On the desk is a laptop.

>z
Time passes.

>z
Time passes.

it's time for bed!

>z
Time passes.

>wait
Time passes.

>wait for 3 hours
I only understood you as far as wanting to wait.

>stall
That's not a verb I recognise.

* * *

>z
Time passes.

>stall
A while passes...

>stall
A while passes...

* * *

I beg your pardon?

>z
Time passes.

it's time for bed!

* * *

>z
Time passes.

>z
Time passes.

it's time for bed!
The time has come to turn in your final project. Your grade is....
C...

    *** The End ***

Would you like to RESTART, RESTORE a saved game, QUIT, or UNDO the last command?

* * *

>z
Time passes.

>z
Time passes.

it's time for bed!
The time has come to turn in your final project. Your grade is....
F for the failure you are :(

    *** The End ***

Would you like to RESTART, RESTORE a saved game, QUIT, or UNDO the last command?